A,A,A,A,A,A,D,D,D,D,D,D,M
0,0,0,0,0,0,0,0,0,0,0,0,M
1,1,1,1,1,0,2,2,2,2,2,0,M
0,0,0,0,0,0,0,0,0,0,0,0,M
3,3,3,3,3,0,4,4,4,4,4,0,M
0,0,0,0,0,0,0,0,0,0,0,0,M
5,5,5,5,5,0,6,6,6,6,6,0,M
0,0,0,0,0,0,0,0,0,0,0,0,M
7,7,7,7,7,0,8,8,8,8,8,0,M
0,0,0,0,0,0,0,0,0,0,0,0,M
9,9,9,9,9,0,10,10,10,10,10,0,M
0,0,0,0,0,0,0,0,0,0,0,0,M
11,11,11,11,11,0,12,12,12,12,12,0,M
0,0,0,0,0,0,0,0,0,0,0,0,M
B,B,B,B,B,B,V,V,V,V,V,V,M
